"aa" = (/turf,/area)
"ab" = (/obj/sand,/turf,/area)
"ac" = (/obj/leaf,/turf,/area)
"ad" = (/obj/mist,/turf,/area)
"ae" = (/obj/nonclan,/turf,/area)
"af" = (/obj/clan,/turf,/area)
"ag" = (/obj/clanslots/clanslot1,/turf,/area)
"ah" = (/obj/clanslots/clanslot2,/turf,/area)
"ai" = (/obj/clanslots/clanslot3,/turf,/area)
"aj" = (/obj/clanslots/clanslot4,/turf,/area)
"ak" = (/obj/clanslots/clanslot5,/turf,/area)
"al" = (/obj/clanslots/clanslot6,/turf,/area)
"am" = (/obj/info,/turf,/area)
"an" = (/turf/Creation,/area)
"ao" = (/obj/done,/turf,/area)
"ap" = (/obj/clanskills,/turf,/area)
"aq" = (/obj/nonclanskills,/turf,/area)
"ar" = (/obj/elementskills,/turf,/area)
"as" = (/obj/passives,/turf,/area)
"at" = (/turf/Main,/turf,/area)
"au" = (/obj/back,/turf,/area)
"av" = (/Jutsu/Akimichi,/turf,/area)
"aw" = (/Jutsu/Hyuuga,/turf,/area)
"ax" = (/Jutsu/Size_Multiplication{pixel_x = -8; pixel_y = -8},/turf,/area)
"ay" = (/Jutsu/Spinach_Pill{pixel_x = -25; pixel_y = -8},/turf,/area)
"az" = (/Jutsu/Byakugan{pixel_y = -8},/turf,/area)
"aA" = (/Jutsu/Nara,/turf,/area)
"aB" = (/Jutsu/Human_Bullet_Tank{pixel_y = 16},/turf,/area)
"aC" = (/Jutsu/Haku,/turf,/area)
"aD" = (/Jutsu/Uchiha,/turf,/area)
"aE" = (/Jutsu/Shadow_Binding{pixel_y = -8},/turf,/area)
"aF" = (/Jutsu/Super_Size_Multiplication{pixel_x = -8; pixel_y = 16},/turf,/area)
"aG" = (/Jutsu/Curry_Pill{pixel_x = 7; pixel_y = 16},/turf,/area)
"aH" = (/Jutsu/Sensatsusuisho{pixel_y = -8},/turf,/area)
"aI" = (/Jutsu/Turning_the_Tide{pixel_x = -8; pixel_y = 16},/turf,/area)
"aJ" = (/Jutsu/Palms{pixel_y = 8},/turf,/area)
"aK" = (/Jutsu/Gentle_Fist{pixel_x = 8; pixel_y = 16},/turf,/area)
"aL" = (/Jutsu/Sharingan_2{pixel_y = -8},/turf,/area)
"aM" = (/Jutsu/Shadow_Neck_Bind{pixel_y = 16},/turf,/area)
"aN" = (/Jutsu/Kaguya,/turf,/area)
"aO" = (/Jutsu/Ice_Explosion{pixel_y = 16},/turf,/area)
"aP" = (/Jutsu/Jashin,/turf,/area)
"aQ" = (/Jutsu/Sharingan_3{pixel_y = 16},/turf,/area)
"aR" = (/Jutsu/Shadow_Sewing{pixel_y = 8},/turf,/area)
"aS" = (/Jutsu/Camellia_Dance{pixel_x = -8; pixel_y = -8},/turf,/area)
"aT" = (/Jutsu/Piercing_Finger_Bullets{pixel_x = 8; pixel_y = -8},/turf,/area)
"aU" = (/Jutsu/Demonic_Ice_Crystal_Mirrors{pixel_y = 8},/turf,/area)
"aV" = (/Jutsu/Death_Ruling_Possession_Blood{pixel_x = 8; pixel_y = -8},/turf,/area)
"aW" = (/Jutsu/Immortality{pixel_x = -8; pixel_y = -8},/turf,/area)
"aX" = (/Jutsu/Sharingan_Copy{pixel_y = 8},/turf,/area)
"aY" = (/Jutsu/Bone_Harden{pixel_y = 16},/turf,/area)
"aZ" = (/Jutsu/Deidara{pixel_x = -1},/turf,/area)
"ba" = (/Jutsu/Larch_Dance{pixel_x = -8; pixel_y = 16},/turf,/area)
"bb" = (/Jutsu/Young_Bracken_Dance{pixel_x = -2; pixel_y = -8},/turf,/area)
"bc" = (/Jutsu/Puppet,/turf,/area)
"bd" = (/Jutsu/Stab_Self{pixel_x = 8; pixel_y = 16},/turf,/area)
"be" = (/Jutsu/Gaara,/turf,/area)
"bf" = (/Jutsu/Exploding_Bird{pixel_x = 8; pixel_y = -8},/turf,/area)
"bg" = (/Jutsu/Exploding_Spider{pixel_x = -9; pixel_y = -8},/turf,/area)
"bh" = (/Jutsu/First_Puppet{pixel_y = -8},/turf,/area)
"bi" = (/Jutsu/Wound_Regeneration{pixel_x = 8; pixel_y = 8},/turf,/area)
"bj" = (/Jutsu/Sand_Shield{pixel_y = -8},/turf,/area)
"bk" = (/Jutsu/Desert_Funeral{pixel_x = -8; pixel_y = 16},/turf,/area)
"bl" = (/Jutsu/Sand_Shuriken{pixel_x = -24; pixel_y = 17},/turf,/area)
"bm" = (/Jutsu/C3{pixel_y = 16},/turf,/area)
"bn" = (/Jutsu/Puppet_Swap{pixel_x = -8; pixel_y = 16},/turf,/area)
"bo" = (/Jutsu/Second_Puppet,/turf,/area)
"bp" = (/Jutsu/Puppet_Transform{pixel_x = -24; pixel_y = 16},/turf,/area)
"bq" = (/Jutsu/Sand_Armor{pixel_y = 16},/turf,/area)
"br" = (/turf/SkillMenuC,/turf,/area)
"bs" = (/Jutsu/Clone,/turf,/area)
"bt" = (/Jutsu/Shadow_Clone{pixel_x = -16},/turf,/area)
"bu" = (/Jutsu/Shuriken_Shadow_Clone,/turf,/area)
"bv" = (/Jutsu/Chakra_Leech{pixel_x = -16},/turf,/area)
"bw" = (/Jutsu/Exploding_Shadow_Clone{pixel_y = -16},/turf,/area)
"bx" = (/Jutsu/Camouflaged_Hiding{pixel_x = -16; pixel_y = 16},/turf,/area)
"by" = (/Jutsu/Rasengan,/turf,/area)
"bz" = (/Jutsu/Large_Rasengan{pixel_x = -16},/turf,/area)
"bA" = (/Jutsu/Opening_Gate,/turf,/area)
"bB" = (/Jutsu/Achiever_of_Nirvana_Fist{pixel_x = -16; step_x = 0},/turf,/area)
"bC" = (/Jutsu/Fear{pixel_x = 16; pixel_y = -16},/turf,/area)
"bD" = (/Jutsu/Energy_Gate{pixel_y = -16},/turf,/area)
"bE" = (/Jutsu/Body_Replacement{pixel_y = 16},/turf,/area)
"bF" = (/Jutsu/Leaf_Whirlwind{pixel_x = -16; pixel_y = 16},/turf,/area)
"bG" = (/Jutsu/Leaf_Great_Whirlwind{pixel_x = -7; pixel_y = 16},/turf,/area)
"bH" = (/Jutsu/Delicate_Extraction{pixel_y = 8},/turf,/area)
"bI" = (/Jutsu/Chakra_Scalpel{pixel_x = 8; pixel_y = 8},/turf,/area)
"bJ" = (/Jutsu/Body_Disruption_Stab{pixel_x = -16; pixel_y = 8},/turf,/area)
"bK" = (/Jutsu/Body_Flicker,/turf,/area)
"bL" = (/Jutsu/Darkness{pixel_x = 16},/turf,/area)
"bM" = (/Jutsu/Life_Gate,/turf,/area)
"bN" = (/Jutsu/Lion_Combo{pixel_x = -7},/turf,/area)
"bO" = (/Jutsu/Healing,/turf,/area)
"bP" = (/Jutsu/Poison_Mist{pixel_x = 8},/turf,/area)
"bQ" = (/Jutsu/Poisoned_Needles{pixel_x = -16},/turf,/area)
"bR" = (/Jutsu/Creation_Rebirth{pixel_x = -14},/turf,/area)
"bS" = (/Jutsu/Transform{pixel_y = -16},/turf,/area)
"bT" = (/Jutsu/Menacing_Palm{pixel_y = -8},/turf,/area)
"bU" = (/Jutsu/Cherry_Blossom_Impact{pixel_x = -4; pixel_y = -8},/turf,/area)
"bV" = (/Jutsu/Temple_of_Nirvana{pixel_x = -16; pixel_y = 16},/turf,/area)
"bW" = (/Jutsu/Pain_Gate{pixel_y = 16},/turf,/area)
"bX" = (/Jutsu/Hidden_Lotus{pixel_y = 16},/turf,/area)
"bY" = (/Jutsu/Chakra_Enhancement_Smash{pixel_y = -13; pixel_z = 0},/turf,/area)
"bZ" = (/Jutsu/Exploding_Kunai,/turf,/area)
"ca" = (/Jutsu/Windmill_Shuriken{pixel_x = -16},/turf,/area)
"cb" = (/Jutsu/Limit_Gate,/turf,/area)
"cc" = (/Jutsu/View_Gate{pixel_x = -16},/turf,/area)
"cd" = (/Jutsu/Wonder_Gate,/turf,/area)
"ce" = (/Jutsu/Chakra_Enhancement{pixel_x = -4; pixel_y = 20},/turf,/area)
"cf" = (/Jutsu/Exploding_Note{pixel_y = 16},/turf,/area)
"cg" = (/Jutsu/Twin_Rising_Dragons{pixel_x = -16; pixel_y = 16},/turf,/area)
"ch" = (/Jutsu/Manipulate_Advancing_Blades{pixel_y = 16},/turf,/area)
"ci" = (/Jutsu/Exploding_Body_Replacement{pixel_x = -16; pixel_y = 16},/turf,/area)
"cj" = (/Jutsu/Shadow_Windmill_Shuriken{pixel_y = 16},/turf,/area)
"ck" = (/Jutsu/Triple_Exploding_Kunai{pixel_y = 16},/turf,/area)
"cl" = (/turf/SkillMenuNC,/turf,/area)
"cm" = (/Jutsu/Chidori_Spear{pixel_x = -1; pixel_y = -5},/turf,/area)
"cn" = (/Jutsu/False_Darkness{pixel_x = 6; pixel_y = -5},/turf,/area)
"co" = (/Jutsu/Lightning{pixel_x = 6; pixel_y = -10},/turf,/area)
"cp" = (/Jutsu/Chidori{pixel_x = 14; pixel_y = -10},/turf,/area)
"cq" = (/Jutsu/Chidori_Needles{pixel_x = -10; pixel_y = -10},/turf,/area)
"cr" = (/Jutsu/Mole_Hiding{pixel_x = -1; pixel_y = -16},/turf,/area)
"cs" = (/Jutsu/Head_Hunter{pixel_x = -24; pixel_y = -16},/turf,/area)
"ct" = (/Jutsu/Four_Pillar_Binding{pixel_x = -1; pixel_y = -16},/turf,/area)
"cu" = (/Jutsu/Iron_Skin{pixel_x = -11; pixel_y = 17},/turf,/area)
"cv" = (/Jutsu/Chidori_Current{pixel_x = 6; pixel_y = 16},/turf,/area)
"cw" = (/Jutsu/Earth{pixel_y = 8},/turf,/area)
"cx" = (/Jutsu/Dungeon_Chamber_of_Nothingness{pixel_x = 8; pixel_y = 8},/turf,/area)
"cy" = (/Jutsu/Split_Earth_Revolution_Palm{pixel_x = -16; pixel_y = 8},/turf,/area)
"cz" = (/Jutsu/Hidden_Mist{pixel_x = 2; pixel_y = -15},/turf,/area)
"cA" = (/Jutsu/Earth_Flow_River{pixel_x = -1},/turf,/area)
"cB" = (/Jutsu/Water_Prison{pixel_x = 10; pixel_y = 16},/turf,/area)
"cC" = (/Jutsu/Bursting_Water_Shockwave{pixel_y = 8},/turf,/area)
"cD" = (/Jutsu/Water{pixel_x = 8; pixel_y = 9},/turf,/area)
"cE" = (/Jutsu/Giant_Vortex{pixel_x = -14; pixel_y = 9},/turf,/area)
"cF" = (/Jutsu/Collision_Destruction{pixel_x = -1; pixel_y = 9},/turf,/area)
"cG" = (/Jutsu/Water_Bullet{pixel_y = 1},/turf,/area)
"cH" = (/Jutsu/Water_Dragon_Projectile{pixel_x = 10; pixel_y = 2},/turf,/area)
"cI" = (/Jutsu/Syrup_Capture{pixel_x = -13; pixel_y = 2},/turf,/area)
"cJ" = (/Jutsu/Ash_Accumulation_Burning{pixel_y = 8},/turf,/area)
"cK" = (/Jutsu/Grand_Fireball{pixel_x = -11},/turf,/area)
"cL" = (/Jutsu/Fire,/turf,/area)
"cM" = (/Jutsu/Hosenka{pixel_x = 9},/turf,/area)
"cN" = (/Jutsu/Fire_Dragon_Flaming_Projectile{pixel_x = -14},/turf,/area)
"cO" = (/Jutsu/Pressure_Damage{pixel_x = -5},/turf,/area)
"cP" = (/Jutsu/Wind{pixel_x = 4},/turf,/area)
"cQ" = (/Jutsu/Great_Breakthrough{pixel_x = -14},/turf,/area)
"cR" = (/Jutsu/Refined_Air_Bullet,/turf,/area)
"cS" = (/Jutsu/Coiling_Flame{pixel_x = 22; pixel_y = -8},/turf,/area)
"cT" = (/Jutsu/Nail_Flower{pixel_x = -23; pixel_y = -8},/turf,/area)
"cU" = (/Jutsu/Blade_of_Wind{pixel_x = 6; pixel_y = -6},/turf,/area)
"cV" = (/Jutsu/Vacuum_Blade{pixel_x = -14; pixel_y = -7},/turf,/area)
"cW" = (/turf/SkillMenuE,/area)
"cX" = (/obj/gui/passives/gauge/rfx,/turf,/area)
"cY" = (/obj/gui/passives/gauge/str,/turf,/area)
"cZ" = (/obj/gui/passives/gauge/int,/turf,/area)
"da" = (/obj/gui/passives/gauge/con,/turf,/area)
"db" = (/obj/gui/passives/rfx/Speed_Demon,/turf,/area)
"dc" = (/obj/gui/passives/rfx/Blindside,/turf,/area)
"dd" = (/obj/gui/passives/str/Built_Solid,/turf,/area)
"de" = (/obj/gui/passives/str/Impact,/turf,/area)
"df" = (/obj/gui/passives/int/Analytical,/turf,/area)
"dg" = (/obj/gui/passives/int/Tracking,/turf,/area)
"dh" = (/obj/gui/passives/con/Efficiency,/turf,/area)
"di" = (/obj/gui/passives/con/Hand_Seal_Mastery,/turf,/area)
"dj" = (/obj/gui/passives/rfx/Rend,/turf,/area)
"dk" = (/obj/gui/passives/rfx/Sword_Mastery,/turf,/area)
"dl" = (/obj/gui/passives/str/Deflection,/turf,/area)
"dm" = (/obj/gui/passives/str/Piercing_Strike,/turf,/area)
"dn" = (/obj/gui/passives/int/Bunshin_Mastery,/turf,/area)
"do" = (/obj/gui/passives/int/Kawa_Mastery,/turf,/area)
"dp" = (/obj/gui/passives/con/Powerhouse,/turf,/area)
"dq" = (/obj/gui/passives/con/Regeneration,/turf,/area)
"dr" = (/obj/gui/passives/rfx/Projectile_Master,/turf,/area)
"ds" = (/obj/gui/passives/rfx/Weak_Spot,/turf,/area)
"dt" = (/obj/gui/passives/str/Combo,/turf,/area)
"du" = (/obj/gui/passives/str/Better_Criticals,/turf,/area)
"dv" = (/obj/gui/passives/int/Genjutsu_Mastery,/turf,/area)
"dw" = (/obj/gui/passives/int/Concentration,/turf,/area)
"dx" = (/obj/gui/passives/con/Medic_Training,/turf,/area)
"dy" = (/obj/gui/passives/con/Pure_Power,/turf,/area)
"dz" = (/turf/SkillMenuP,/area)

(1,1,1) = {"
aaaaaaaaaaaaaaaaaaaaaaaaaaaaaaaaaa
aaaaaaaaaaaaaaaaaaaaaaaaaaaaaaaaaa
aaaaaaaaaaaaaaaaaaaaaaaaaaaaaaaaaa
aaaaaaaaabaaaaacaaaaadaaaaaaaaaaaa
aaaaaaaaaaaaaaaaaaaaaaaaaaaaaaaaaa
aaaaaaaaaaaaaaaaaaaaaaaaaaaaaaaaaa
aaaeaaaaaaaaaaaaaaafaaaaaaaaaaaaaa
aaaaaaaaaaaaaaaaaaaaaaaaaaaaaaaaaa
aaaaaaaaaaaaaaaaaaaaaaaaaaaaaaaaaa
aaagaaaaahaaaiaaaaajaaakaaaaalaaaa
aaaaaaaaaaaaaaaaaaaaaaaaaaaaaaaaaa
aaaaaaaaaaaaaaaaaaaaaaaaaaaaaaaaaa
aaaaaaaaaaaaaaaaaaaaaaaaaaaaaaaaaa
aaaaaaaaaaaaaaaaaaaaaaaaaaaaaaaaaa
aaaaaaaaaaaaaaaaaaaaaaaaaaaaaaaaaa
aaamaaaaaaaaaaaaaaaaaaaaaaaaaaaaaa
anaaaaaaaaaaaaaaaaaaaaaaaaaoaaaaaa
"}

(1,1,2) = {"
aaaaaaaaaaaaaaaaaaaaaaaaaaaaaaaaaa
aaaaaaaaaaaaaaaaaaaaaaaaaaaaaaaaaa
aaaaaaaaaaaaaaaaaaaaaaaaaaaaaaaaaa
aaaaaaaaaaaaaaaaaaaaaaaaaaaaaaaaaa
aaaaaaapapapapapapapapapapapaaaaaa
aaaaaaapapapapapapapapapapapaaaaaa
aaaaaaaaaaaaaaaaaaaaaaaaaaaaaaaaaa
aaaqaqaqaqaqaqaqaqaqaqaqaqaqaqaqaa
aaaqaqaqaqaqaqaqaqaqaqaqaqaqaqaqaa
aaaaaaaaaaaaaaaaaaaaaaaaaaaaaaaaaa
aaarararararararararararararararaa
aaaaararararararararararararararaa
aaaaasasasasasasasasaaaaaaaaaaaaaa
aaaaasasasasasasasasaaaaaaaaaaaaaa
aaaaaaaaaaaaaaaaaaaaaaaaaaaaaaaaaa
aaaaaaaaaaaaaaaaaaaaaaaaaaaaaaaaaa
ataaaaaaaaaaaaaaaaaaaaaaaaaaaaaaaa
"}

(1,1,3) = {"
aaaaaaaaaaaaaaaaaaaaaaaaaaaaaaaaaa
aaauauaaaaaaaaaaaaaaaaaaaaaaaaaaaa
aaaaaaaaaaaaaaaaaaaaaaaaaaaaaaaaaa
aaaaaaaaaaavaaaaaaaaaaawaaaaaaaaaa
aaaaaaaaaxaaaaayaaaaaaazaaaaaaaaaa
aaaAaaaaaaaBaaaaaCaaaaaaaaaaaaaDaa
aaaEaaaaaFaaaGaaaHaaaIaJaKaaaaaLaa
aaaaaaaaaaaaaaaaaaaaaaaaaaaaaaaaaa
aaaMaaaaaaaNaaaaaOaaaaaPaaaaaaaQaa
aaaRaaaaaSaaaTaaaUaaaVaaaWaaaaaXaa
aaaaaaaaaaaYaaaaaaaaaaaaaaaaaaaaaa
aaaaaZaababbaaaabcaabdaaaaaabeaaaa
aabfaabgaaaaaaaabhaabiaaaaaabjaaaa
aaaaaaaaaaaaaaaaaaaaaaaaaabkaaaabl
aaaabmaaaaaaaabnboaabpaaaaaabqaaaa
aaaaaaaaaaaaaaaaaaaaaaaaaaaaaaaaaa
braaaaaaaaaaaaaaaaaaaaaaaaaaaaaaaa
"}

(1,1,4) = {"
aaaaaaaaaaaaaaaaaaaaaaaaaaaaaaaaaa
aaauauaaaaaaaaaaaaaaaaaaaaaaaaaaaa
aaaaaaaaaaaaaaaaaaaaaaaaaaaaaaaaaa
aabsaabtbuaabvaaaaaaaaaaaaaaaaaaaa
aaaaaaaabwaaaaaaaaaaaaaaaaaaaaaaaa
aaaaaaaaaaaabxaaaaaaaaaaaaaaaaaaaa
aabyaabzaabAaabBaaaaaaaaaaaaaaaaaa
aaaabCaaaabDaaaaaaaaaaaaaaaaaaaaaa
aabEaaaaaaaaaabFbGaaaabHbIaabJaaaa
aabKbLaaaabMaaaabNaaaabObPaabQbRaa
aabSaaaaaaaaaaaaaaaaaabTaabUaaaaaa
aaaaaabVaabWaaaabXaaaaaaaaaabYaaaa
aabZaacaaacbaacccdaaaaaaaaceaaaaaa
aaaaaaaaaaaaaaaaaaaaaaaaaaaaaaaaaa
aacfaacgchaacicjaackaaaaaaaaaaaaaa
aaaaaaaaaaaaaaaaaaaaaaaaaaaaaaaaaa
claaaaaaaaaaaaaaaaaaaaaaaaaaaaaaaa
"}

(1,1,5) = {"
aaaaaaaaaaaaaaaaaaaaaaaaaaaaaaaaaa
aaauauaaaaaaaaaaaaaaaaaaaaaaaaaaaa
aaaaaaaaaaaaaaaaaaaaaaaaaaaaaaaaaa
aaaaaaaacmcnaaaaaaaaaaaaaaaaaaaaaa
aaaaaaaaaacocpaacqaaaaaacraacsaaaa
aaaaaaaactaaaaaaaaaaaacuaaaaaaaaaa
aaaaaaaaaacvaaaaaaaaaaaacwcxaacyaa
aaczaaaaaaaaaaaaaaaaaaaacAaaaaaaaa
aaaacBaaaaaaaaaaaaaaaaaaaaaaaaaaaa
aacCcDaacEcFaaaaaaaaaaaaaaaaaaaaaa
aacGcHaacIaaaaaaaaaaaaaaaaaaaaaaaa
aaaaaaaaaaaaaaaaaaaaaaaacJaaaaaaaa
aaaaaaaaaaaaaaaaaaaaaacKcLcMaacNaa
aaaaaacOcPaacQcRaaaacSaaaaaacTaaaa
aaaaaaaacUaacVaaaaaaaaaaaaaaaaaaaa
aaaaaaaaaaaaaaaaaaaaaaaaaaaaaaaaaa
cWaaaaaaaaaaaaaaaaaaaaaaaaaaaaaaaa
"}

(1,1,6) = {"
aaaaaaaaaaaaaaaaaaaaaaaaaaaaaaaaaa
aaauauaaaaaaaaaaaaaaaaaaaaaaaaaaaa
aaaaaaaaaaaaaaaaaaaaaaaaaaaaaaaaaa
aaaacXaaaaaacYaaaaaacZaaaaaadaaaaa
aaaaaaaaaaaaaaaaaaaaaaaaaaaaaaaaaa
aadbaadcaaddaadeaadfaadgaadhaadiaa
aaaaaaaaaaaaaaaaaaaaaaaaaaaaaaaaaa
aadjaadkaadlaadmaadnaadoaadpaadqaa
aaaaaaaaaaaaaaaaaaaaaaaaaaaaaaaaaa
aadraadsaadtaaduaadvaadwaadxaadyaa
aaaaaaaaaaaaaaaaaaaaaaaaaaaaaaaaaa
aaaaaaaaaaaaaaaaaaaaaaaaaaaaaaaaaa
aaaaaaaaaaaaaaaaaaaaaaaaaaaaaaaaaa
aaaaaaaaaaaaaaaaaaaaaaaaaaaaaaaaaa
aaaaaaaaaaaaaaaaaaaaaaaaaaaaaaaaaa
aaaaaaaaaaaaaaaaaaaaaaaaaaaaaaaaaa
dzaaaaaaaaaaaaaaaaaaaaaaaaaaaaaaaa
"}
